-47
41
-17
24
00000000000000000000000000000000000000000000000000000000000000000000000000000000000000000
11111111111111111111111111111111111111111111111111111111111111111111111111111111111111110
10000000000000000000000000000000000000000000000000000000000000000000000000000000000000010
10000000000000000000000000000000000000000000000000000000000000000000000000000000000000010
10000000000000000000000000000000000000000000000000000000000000000000000000000000000000010
10000000000000000000000000000000000000000000000000000000000000000000000000000000000000010
10000000000000000000000000000000000000000000000000000000000000000000000000000000000000010
10000000000000000000000000000000000000000000000000000000000000000000000000000000000000010
10000000000000000000000000000000000000000000000000000000000000000000000000000000000000010
10000000000000000000000000000000000000000000000000000000000000000000000000000000000000010
10000000000000000000000000000000000000000000000000000000000000000000000000000000000000010
10000000000000000000000000000000000000000000000000000000000000000000000000000000000000010
10000000000000000000000000000000000000000000000000000000000000000000000000000000000000010
10000000000000000000000000000000000000000000000000000000000000000000000000000000000000010
10000000000000000000000000000000000000000000000000000000000000000000000000000000000000010
10000000000000000000000000000000000000000000000000000000000000000000000000000000000000010
10000000000000000000000000000000000000000000000000000000000000000000000000000000002222220
10000000000000000000000000000000000000000000000000000000000000000000000000000000002222220
10000000000000000000000000000000000000000000000000000000000000000000000000000000002222220
10000000000000000000000000000000000000000000000000000000000000000000000000000000002222220
10000000000000000000000000000000000000000000000000000000000000000000000000000000002222220
10000000000000000000000000000000000000000000000000000000000000000000000000000000002222220
10000000000000000000000000000000000000000000000000000000000000000000000000000000000000010
10000000000000000000000000000000000000000000000000000000000000000000000000000000000000010
10000000000000000000000000000000000000000000000000000000000000000000000000000000000000010
10000000000000000000000000000000000000000000000000000000000000000000000000000000000000010
10000000000000000000000000000000000000000000000000000000000000000000000000000000000000010
10000000000000000000000000000000000000000000000000000000000000000000000000000000000000010
10000000000000000000000000000000000000000000000000000000000000000000000000000000000000010
10000000000000000000000000000000000000000000000000000000000000000000000000000000000000010
10000000000000000000000000000000000000000000000000000000000000000000000000000000000000010
10000000000000000000000000000000000000000000000000000000000000000000000000000000000000010
10000000000000000000000000000000000000000000000000000000000000000000000000000000000000010
10000000000000000000000000000000000000000000000000000000000000000000000000000000000000010
10000000000000000000000000000000000000000000000000000000000000000000000000000000000000010
10000000000000000000000000000000000000000000000000000000000000000000000000000000000000010
10000000000000000000000000000000000000000000000000000000000000000000000000000000000000010
10000000000000000000000000000000000000000000000000000000000000000000000000000000000000010
10000000000000000000000000000000000000000000000000000000000000000000000000000000000000010
10000000000000000000000000000000000000000000000000000000000000000000000000000000000000010
10000000000000000000000000000000000000000000000000000000000000000000000000000000000000010
11111111111111111111111111111111111111111111111111111111111111111111111111111111111111110
